n_n_n_n_n_n_n_n_n_n_n_n_n_n_n_n_n_n_n_n_n_n_n_n_n_n_n_n_
n_n_d_d_d_d_d_n_n_n_n_n_d_d_d_n_n_n_n_n_n_n_n_n_n_n_n_n_
n_n_d_d_d_d_d_d_d_d_n_n_d_dPd_n_n_n_d_d_d_d_n_n_n_n_n_n_
n_n_d_d_d_d_d_n_n_d_n_n_d_d_d_n_n_n_n_n_n_d_n_n_n_n_n_n_
n_n_n_n_d_n_n_n_n_d_n_n_n_d_n_n_n_n_n_n_n_d_n_d_d_d_d_n_
n_n_n_n_d_n_n_n_n_d_d_d_d_d_d_d_d_d_d_n_n_d_d_d_d_d_d_n_
n_n_n_n_d_n_n_n_n_n_n_n_n_d_n_n_n_n_d_n_n_n_n_d_d_d_d_n_
n_n_d_d_d_d_d_n_n_n_n_n_n_n_n_n_n_n_d_n_n_n_n_d_d_d_d_n_
n_n_d_d_d_d_d_d_d_d_d_d_d_d_d_d_d_d_d_n_n_n_n_n_n_d_n_n_
n_n_d_d_d_d_d_n_n_n_n_n_n_n_n_n_n_n_n_n_n_n_n_n_n_d_n_n_
n_n_n_n_d_n_n_n_n_n_n_n_n_n_d_d_d_d_d_d_d_d_n_n_n_d_n_n_
n_n_n_n_d_n_n_n_n_n_n_n_n_n_d_d_d_d_d_d_d_d_n_n_n_d_n_n_
n_n_n_n_d_n_n_d_d_d_d_d_n_n_d_d_d_d_d_d_d_d_n_n_n_d_n_n_
n_n_d_d_d_d_d_d_d_d_d_d_d_d_d_n_n_n_d_n_n_n_n_n_n_d_n_n_
n_n_n_n_n_n_n_d_d_d_d_d_n_n_n_n_n_n_d_n_n_n_n_n_n_d_n_n_
n_n_n_n_d_n_n_n_n_d_n_n_n_n_n_n_d_d_d_d_d_n_n_n_n_d_n_n_
n_n_n_n_d_n_n_n_n_d_n_n_n_n_n_n_d_d_d_d_d_d_d_d_d_d_n_n_
n_n_n_n_d_n_n_n_n_d_d_d_d_d_n_n_d_d_d_d_d_n_n_n_n_d_n_n_
n_n_d_d_d_d_n_n_n_d_n_n_n_d_n_n_n_n_n_n_n_n_n_n_n_d_n_n_
n_n_d_n_n_d_n_n_n_d_n_n_n_d_n_n_n_n_n_n_n_n_n_n_n_d_n_n_
n_n_d_n_n_n_n_n_d_d_d_d_d_d_d_d_d_d_d_d_d_d_d_d_d_d_n_n_
n_n_d_n_n_n_n_n_n_n_n_n_n_n_n_n_n_n_d_n_n_n_n_d_n_n_n_n_
n_n_d_d_d_d_d_d_n_n_d_d_d_d_d_d_d_d_d_d_d_d_n_d_n_n_n_n_
n_n_d_n_n_d_d_d_n_n_d_n_n_d_n_n_n_n_d_n_n_n_n_d_n_n_n_n_
n_n_d_n_n_d_d_d_n_n_d_n_n_d_n_n_n_n_d_n_n_d_d_d_d_d_n_n_
n_n_d_n_n_d_d_d_d_d_d_n_d_dOd_n_n_n_d_d_d_d_d_d_d_d_n_n_
n_n_n_n_n_n_n_n_n_n_n_n_d_d_d_n_n_n_n_n_n_n_n_n_n_n_n_n_
n_n_n_n_n_n_n_n_n_n_n_n_n_n_n_n_n_n_n_n_n_n_n_n_n_n_n_n_
