n_n_n_n_n_n_n_n_n_n_n_n_n_n_n_n_n_n_n_n_n_n_n_n_n_n_n_n_
n_d_d_d_n_n_n_n_n_n_n_n_n_n_n_n_n_n_n_n_n_d_d_d_n_n_n_n_
n_d_d_d_n_n_n_n_n_n_n_n_d_d_d_n_n_n_n_n_n_d_d_d_n_n_n_n_
n_n_d_n_n_n_n_d_d_d_d_d_d_dPd_n_n_n_n_n_n_d_d_d_n_n_n_n_
n_n_d_n_n_n_n_d_n_n_n_n_d_d_d_n_n_n_n_n_n_n_d_n_n_n_n_n_
n_n_d_d_d_d_d_d_n_n_n_n_n_n_n_n_n_n_n_n_n_n_d_n_n_n_n_n_
n_n_d_n_n_n_n_n_n_n_n_n_n_n_n_n_n_n_n_n_n_n_d_n_n_n_n_n_
n_n_d_n_n_n_n_n_n_n_n_n_n_n_n_n_n_n_n_d_d_d_d_d_d_d_n_n_
n_n_d_n_n_n_n_n_n_n_n_d_d_d_d_d_n_n_n_d_d_d_d_d_d_d_n_n_
n_n_d_d_d_d_d_d_n_n_n_d_d_d_d_d_n_n_n_d_d_d_d_d_d_d_n_n_
n_n_n_d_n_n_n_d_n_n_n_d_d_d_d_d_n_n_n_d_d_d_d_d_d_d_n_n_
n_n_n_d_n_n_n_d_n_n_n_n_n_d_n_n_n_n_n_n_n_n_d_n_n_n_n_n_
n_n_d_d_d_n_n_d_n_n_n_n_n_d_n_n_n_n_n_n_n_n_d_n_n_n_n_n_
n_n_d_d_d_n_n_d_n_n_n_n_n_d_n_n_n_n_n_n_d_d_d_d_d_n_n_n_
n_n_d_d_d_n_n_d_n_n_n_n_n_d_n_n_n_n_n_n_d_n_n_n_d_n_n_n_
n_n_n_n_n_n_n_d_d_d_d_d_d_d_d_d_d_d_d_d_d_n_n_n_d_n_n_n_
n_n_n_n_n_n_n_d_n_n_n_n_n_n_n_n_n_n_n_n_d_n_n_n_d_n_n_n_
n_n_n_n_n_n_n_d_n_n_n_n_n_n_n_n_n_n_n_n_d_n_n_n_d_n_n_n_
n_n_d_d_d_n_n_d_n_n_d_d_d_n_n_n_n_n_d_d_d_d_n_n_d_n_n_n_
n_n_d_d_d_d_d_d_d_d_d_d_d_n_n_n_n_n_d_d_d_d_n_n_d_n_n_n_
n_n_d_d_d_n_n_d_n_n_d_d_d_n_n_n_n_n_d_d_d_d_n_n_d_n_n_n_
n_n_n_n_n_n_n_d_n_n_n_n_n_n_n_n_n_n_n_n_n_n_n_n_d_n_n_n_
n_n_n_n_n_n_n_d_n_n_n_n_n_n_d_d_d_d_d_d_d_d_d_d_d_n_n_n_
n_n_n_n_n_n_d_d_d_d_n_n_n_n_d_n_n_n_n_n_n_n_n_n_n_n_n_n_
n_n_n_n_n_n_d_d_d_d_n_n_n_n_d_n_n_n_n_n_n_n_n_n_n_n_n_n_
n_n_n_n_n_n_d_d_d_d_n_n_d_d_d_d_d_n_n_n_n_n_n_n_n_n_n_n_
n_n_n_n_n_n_n_n_n_n_n_n_d_d_dOd_d_n_n_n_n_n_n_n_n_n_n_n_
n_n_n_n_n_n_n_n_n_n_n_n_n_n_n_n_n_n_n_n_n_n_n_n_n_n_n_n_
